111111111111111111111111111111111111111111
100000000000000000000000000000000000000001
10000000000000010000000000000000C001000001
10000000000000010000000000C0000000000C0001
100000E0000000010000100000C0000000000C0001
10000000000000010000000000C000000000000001
100000000000000C0000000000P0000000000C0001
100000000000000C000000000000000000000C0001
100000000000000C000000000000000000000C0001
100000000000000C000000000000000000000C0001
100000000000000C000000000000000000000C0001
100000000000000C000000000000000000000C0001
100000000000000C000000000000000000000C0001
100000000000000C000000000000000000000C0001
100000000000000C000000000000000000000C0001
100000000000000C000000000000000000000C0001
100000000000000C000000000000000000000C0001
100000000000000C000000000000000000000C0001
100000000000000C000000000000000000000C0001
100000000000000C000000000000000000000C0001
100000000000000C000000000000000000000C0001
100000000000000C000000000000000000000C0001
111111111111111111111111111111111111111111
