1111111
11E0001
10CX001
1000001
100X0C1
1PC0001
1111111
