1111111
11E0001
10C0001
1000001
10000C1
1PC0001
1111111
